dorchester	maryland_counties
washington	maryland_counties
st._mary's	maryland_counties
montgomery	maryland_counties
caroline	maryland_counties
baltimore	maryland_counties
charles	maryland_counties
garrett	maryland_counties
talbot	maryland_counties
cecil	maryland_counties
calvert	maryland_counties
somerset	maryland_counties
carroll	maryland_counties
kent	maryland_counties
worcester	maryland_counties
charles_bukowski	english_poets
william_butler_yeats	english_poets
sean_o'brien	english_poets
sidney_keyes	english_poets
gertrude_stein	english_poets
oscar_wilde	english_poets
anthony_burgess	english_poets
ralph_waldo_emerson	english_poets
ted_hughes	english_poets
robert_burns	english_poets
walt_whitman	english_poets
wilfred_owen	english_poets
jackson_mac_low	english_poets
thomas_hardy	english_poets
philip_larkin	english_poets
d._h._lawrence	english_poets
james_joyce	english_poets
robert_graves	english_poets
kingsley_amis	english_poets
john_updike	english_poets
brion_gysin	english_poets
jack_kerouac	english_poets
leonard_cohen	english_poets
robert_louis_stevenson	english_poets
amiri_baraka	english_poets
john_keats	english_poets
henry_king	english_poets
dorothy_wordsworth	english_poets
david_jones	english_poets
father_goose	english_poets
henry_wadsworth_longfellow	english_poets
james_weldon_johnson	english_poets
tupac_shakur	english_poets
henry_david_thoreau	english_poets
edward_thomas	english_poets
george_herbert	english_poets
patti_smith	english_poets
oscar_williams	english_poets
felicia_hemans	english_poets
thomas_love_peacock	english_poets
rudyard_kipling	english_poets
carl_sandburg	english_poets
edward_lear	english_poets
essex_hemphill	english_poets
william_shakespeare	english_poets
john_cage	english_poets
william_morris	english_poets
samuel_taylor_coleridge	english_poets
louis_zukofsky	english_poets
langston_hughes	english_poets
arthur_symons	english_poets
t._s._eliot	english_poets
james_dickey	english_poets
margaret_atwood	english_poets
dylan_thomas	english_poets
john_davidson	english_poets
edgar_allan_poe	english_poets
thomas_campion	english_poets
allen_ginsberg	english_poets
james_russell_lowell	english_poets
w._h._auden	english_poets
emily_dickinson	english_poets
edmund_blunden	english_poets
siegfried_sassoon	english_poets
rita_dove	english_poets
kathy_acker	english_poets
thomas_gray	english_poets
samuel_johnson	english_poets
anne_sexton	english_poets
percy_bysshe_shelley	english_poets
sylvia_plath	english_poets
stevie_smith	english_poets
tobias_smollett	english_poets
seasons	english_poets
john_betjeman	english_poets
bob_dylan	english_poets
robert_penn_warren	english_poets
william_blake	english_poets
may_sarton	english_poets
sara_teasdale	english_poets
henry_lawson	english_poets
william_wordsworth	english_poets
william_s._burroughs	english_poets
erica_jong	english_poets
poet	english_poets
andrew_marvell	english_poets
paradise	cocktails
douglas	cocktails
cyprus	cocktails
nixon	cocktails
pall_mall	cocktails
stinger	cocktails
lorraine	cocktails
flip	cocktails
prince_of_wales	cocktails
caesar	cocktails
mimosa	cocktails
manhattan	cocktails
blue_hawaii	cocktails
churchill	cocktails
kangaroo	cocktails
godfather	cocktails
sun_city	cocktails
cape_cod	cocktails
bishop	cocktails
heart_of_fire	cocktails
madras	cocktails
panama	cocktails
rob_roy	cocktails
hurricane	cocktails
my_fair_lady	cocktails
colombia	cocktails
fix	cocktails
bloody_mary	cocktails
martini	cocktails
montgomery	cocktails
zombie	cocktails
daisy	cocktails
margarita	cocktails
gibson	cocktails
backdraft	cocktails
cocktail	cocktails
collins	cocktails
alexander	cocktails
cosmopolitan	cocktails
dragonfly	cocktails
bronx	cocktails
greyhound	cocktails
tequila_sunrise	cocktails
euboea	greek_islands
santorini	greek_islands
zakynthos	greek_islands
amorgos	greek_islands
crete	greek_islands
ithaca	greek_islands
corfu	greek_islands
lefkada	greek_islands
hydra	greek_islands
dia	greek_islands
naxos	greek_islands
kea	greek_islands
mykonos	greek_islands
kefalonia	greek_islands
sparta	greek_gods
crete	greek_gods
maia	greek_gods
andromeda	greek_gods
nestor	greek_gods
jason	greek_gods
uranus	greek_gods
orion	greek_gods
electra	greek_gods
narcissus	greek_gods
athena	greek_gods
eos	greek_gods
orpheus	greek_gods
hermes	greek_gods
hector	greek_gods
ares	greek_gods
echo	greek_gods
icarus	greek_gods
pandora	greek_gods
achilles	greek_gods
deucalion	greek_gods
bias	greek_gods
arion	greek_gods
circe	greek_gods
doris	greek_gods
eris	greek_gods
daphne	greek_gods
cassandra	greek_gods
clio	greek_gods
medusa	greek_gods
medea	greek_gods
cleopatra	greek_gods
paris	greek_gods
argos	greek_gods
car	greek_gods
charon	greek_gods
europa	greek_gods
phoenix	greek_gods
io	greek_gods
hestia	greek_gods
aphrodite	greek_gods
endymion	greek_gods
iris	greek_gods
calliope	greek_gods
euterpe	greek_gods
callisto	greek_gods
zeus	greek_gods
acheron	greek_gods
erebus	greek_gods
castor	greek_gods
calypso	greek_gods
styx	greek_gods
nike	greek_gods
helen	greek_gods
perseus	greek_gods
adonis	greek_gods
memnon	greek_gods
urania	greek_gods
triton	greek_gods
pygmalion	greek_gods
arachne	greek_gods
pan	greek_gods
kronos	greek_gods
poseidon	greek_gods
dia	greek_gods
chaos	greek_gods
nemesis	greek_gods
actor	greek_gods
argus	greek_gods
proteus	greek_gods
apollo	greek_gods
fremantle	australian_cities
tamworth	australian_cities
toowoomba	australian_cities
mount_gambier	australian_cities
hobart	australian_cities
bendigo	australian_cities
rockhampton	australian_cities
orange	australian_cities
ballarat	australian_cities
melbourne	australian_cities
ipswich	australian_cities
brisbane	australian_cities
albury	australian_cities
lismore	australian_cities
newcastle	australian_cities
townsville	australian_cities
mackay	australian_cities
sydney	australian_cities
grafton	australian_cities
canberra	australian_cities
hamilton	australian_cities
ararat	australian_cities
perth	australian_cities
geelong	australian_cities
palmerston	australian_cities
horsham	australian_cities
albany	australian_cities
burnie	australian_cities
cairns	australian_cities
adelaide	australian_cities
darwin	australian_cities
gold_coast	australian_cities
bathurst	australian_cities
launceston	australian_cities
wollongong	australian_cities
gladstone	australian_cities
john_ireland	composers
franz_schubert	composers
leonard_bernstein	composers
robert_schumann	composers
richard_harris	composers
denis_diderot	composers
john_cage	composers
stephen_sondheim	composers
andrew_lloyd_webber	composers
pyotr_ilyich_tchaikovsky	composers
james_douglas	composers
frederick	composers
franz_liszt	composers
hoagy_carmichael	composers
johann_sebastian_bach	composers
maurice_ravel	composers
jackie_gleason	composers
giacomo_puccini	composers
irving_berlin	composers
igor_stravinsky	composers
desi_arnaz	composers
gustav_mahler	composers
michael_gordon	composers
steve_allen	composers
spencer_williams	composers
cole_porter	composers
john_williams	composers
william_perry	composers
george	composers
noel_coward	composers
george_enescu	composers
aaron_copland	composers
ludwig_van_beethoven	composers
glenn_gould	composers
george_gershwin	composers
richard_wagner	composers
arnold_schoenberg	composers
max_bruch	composers
david_foster	composers
władysław_szpilman	composers
johannes_brahms	composers
antonio_salieri	composers
frank_zappa	composers
danny_elfman	composers
ivor_novello	composers
wolfgang_amadeus_mozart	composers
charles_ives	composers
william_walker	composers
yamaguchi	japanese_prefectures
nagano	japanese_prefectures
miyagi	japanese_prefectures
shizuoka	japanese_prefectures
yamagata	japanese_prefectures
okinawa	japanese_prefectures
tokyo	japanese_prefectures
tokushima	japanese_prefectures
kumamoto	japanese_prefectures
okayama	japanese_prefectures
saitama	japanese_prefectures
nagasaki	japanese_prefectures
nara	japanese_prefectures
akita	japanese_prefectures
osaka	japanese_prefectures
niigata	japanese_prefectures
fukuoka	japanese_prefectures
kagoshima	japanese_prefectures
yamanashi	japanese_prefectures
saga	japanese_prefectures
chiba	japanese_prefectures
kyoto	japanese_prefectures
ibaraki	japanese_prefectures
toyama	japanese_prefectures
miyazaki	japanese_prefectures
kochi	japanese_prefectures
aomori	japanese_prefectures
rockwall	texas_counties
ward	texas_counties
yoakum	texas_counties
houston	texas_counties
wharton	texas_counties
coleman	texas_counties
waller	texas_counties
delta	texas_counties
sherman	texas_counties
franklin	texas_counties
armstrong	texas_counties
tom_green	texas_counties
leon	texas_counties
madison	texas_counties
hall	texas_counties
crockett	texas_counties
hartley	texas_counties
hays	texas_counties
burleson	texas_counties
johnson	texas_counties
nacogdoches	texas_counties
cochran	texas_counties
liberty	texas_counties
williamson	texas_counties
oldham	texas_counties
andrews	texas_counties
hockley	texas_counties
dallas	texas_counties
hood	texas_counties
wheeler	texas_counties
wichita	texas_counties
harris	texas_counties
gray	texas_counties
castro	texas_counties
taylor	texas_counties
carson	texas_counties
hutchinson	texas_counties
travis	texas_counties
jackson	texas_counties
king	texas_counties
bell	texas_counties
floyd	texas_counties
smith	texas_counties
haskell	texas_counties
calhoun	texas_counties
cass	texas_counties
red_river	texas_counties
kaufman	texas_counties
jefferson	texas_counties
presidio	texas_counties
orange	texas_counties
loving	texas_counties
grayson	texas_counties
victoria	texas_counties
cameron	texas_counties
terry	texas_counties
san_saba	texas_counties
hopkins	texas_counties
crane	texas_counties
midland	texas_counties
jones	texas_counties
terrell	texas_counties
uvalde	texas_counties
knox	texas_counties
hunt	texas_counties
crosby	texas_counties
montague	texas_counties
mitchell	texas_counties
lubbock	texas_counties
fayette	texas_counties
morris	texas_counties
refugio	texas_counties
hill	texas_counties
guadalupe	texas_counties
wilson	texas_counties
stonewall	texas_counties
el_paso	texas_counties
hardin	texas_counties
burnet	texas_counties
bowie	texas_counties
san_augustine	texas_counties
jasper	texas_counties
pecos	texas_counties
walker	texas_counties
robertson	texas_counties
archer	texas_counties
goliad	texas_counties
menard	texas_counties
blanco	texas_counties
gillespie	texas_counties
hamilton	texas_counties
bastrop	texas_counties
stephens	texas_counties
brown	texas_counties
trinity	texas_counties
montgomery	texas_counties
sterling	texas_counties
upton	texas_counties
medina	texas_counties
bailey	texas_counties
potter	texas_counties
kendall	texas_counties
galveston	texas_counties
brooks	texas_counties
kenedy	texas_counties
hale	texas_counties
jeff_davis	texas_counties
titus	texas_counties
hemphill	texas_counties
newton	texas_counties
rusk	texas_counties
brazoria	texas_counties
nolan	texas_counties
moore	texas_counties
caldwell	texas_counties
hidalgo	texas_counties
borden	texas_counties
ellis	texas_counties
eastland	texas_counties
dawson	texas_counties
henderson	texas_counties
howard	texas_counties
colorado	texas_counties
angelina	texas_counties
parker	texas_counties
maverick	texas_counties
roberts	texas_counties
callahan	texas_counties
dickens	texas_counties
edwards	texas_counties
anderson	texas_counties
shelby	texas_counties
marion	texas_counties
lynn	texas_counties
zapata	texas_counties
lee	texas_counties
wood	texas_counties
kent	texas_counties
comanche	texas_counties
llano	texas_counties
jack	texas_counties
webb	texas_counties
young	texas_counties
real	texas_counties
clay	texas_counties
austin	texas_counties
lamb	texas_counties
lampasas	texas_counties
mills	texas_counties
martin	texas_counties
sutton	texas_counties
fisher	texas_counties
tyler	texas_counties
mason	texas_counties
throckmorton	texas_counties
live_oak	texas_counties
childress	texas_counties
bee	texas_counties
denton	texas_counties
brewster	texas_counties
gonzales	texas_counties
washington	texas_counties
wise	texas_counties
camp	texas_counties
ourense	spanish_provinces
albacete	spanish_provinces
tarragona	spanish_provinces
lugo	spanish_provinces
león	spanish_provinces
cáceres	spanish_provinces
huesca	spanish_provinces
lleida	spanish_provinces
la_rioja	spanish_provinces
santa_cruz_de_tenerife	spanish_provinces
soria	spanish_provinces
madrid	spanish_provinces
guadalajara	spanish_provinces
ceuta	spanish_provinces
almería	spanish_provinces
cádiz	spanish_provinces
barcelona	spanish_provinces
girona	spanish_provinces
badajoz	spanish_provinces
ciudad_real	spanish_provinces
huelva	spanish_provinces
cantabria	spanish_provinces
teruel	spanish_provinces
pontevedra	spanish_provinces
alicante	spanish_provinces
jaén	spanish_provinces
valladolid	spanish_provinces
a_coruña	spanish_provinces
salamanca	spanish_provinces
murcia	spanish_provinces
Ávila	spanish_provinces
málaga	spanish_provinces
burgos	spanish_provinces
valencia	spanish_provinces
córdoba	spanish_provinces
las_palmas	spanish_provinces
palencia	spanish_provinces
toledo	spanish_provinces
asturias	spanish_provinces
segovia	spanish_provinces
granada	spanish_provinces
galileo_galilei	astronomers
frank_k._edmondson	astronomers
james_bradley	astronomers
isaac_newton	astronomers
david_levy	astronomers
stephen_hawking	astronomers
michael	astronomers
ted	astronomers
edward	astronomers
pierre-simon_laplace	astronomers
james_ferguson	astronomers
johannes_kepler	astronomers
mike	astronomers
robert_wilson	astronomers
fred_hoyle	astronomers
robert_kraft	astronomers
nicolaus_copernicus	astronomers
will_hay	astronomers
media	stars
electra	stars
rana	stars
castor	stars
polaris	stars
nash	stars
sun	stars
altair	stars
ain	stars
atlas	stars
peacock	stars
arm	stars
sirius	stars
algol	stars
maia	stars
vega	stars
spica	stars
mira	stars
antares	stars
iron_man	superheros
balder	superheros
the_phantom	superheros
v	superheros
mark	superheros
ghost_rider	superheros
northstar	superheros
captain_america	superheros
spider-man	superheros
firestorm	superheros
the_punisher	superheros
apollo	superheros
rage	superheros
grayson	superheros
red_star	superheros
nightwing	superheros
longshot	superheros
darkman	superheros
cypher	superheros
santo	superheros
shaman	superheros
tag	superheros
billy	superheros
iron_fist	superheros
omi	superheros
comics	superheros
daredevil	superheros
steel	superheros
speedy	superheros
neo	superheros
tiny	superheros
link	superheros
cyborg	superheros
renegade	superheros
gateway	superheros
static	superheros
ronin	superheros
ghost	superheros
underdog	superheros
impulse	superheros
quicksilver	superheros
magneto	superheros
doctor_strange	superheros
iceman	superheros
mimic	superheros
changeling	superheros
black_lightning	superheros
solo	superheros
avatar	superheros
justice	superheros
bishop	superheros
juggernaut	superheros
marvel_comics	superheros
beast	superheros
cable	superheros
batman	superheros
sunspot	superheros
jericho	superheros
bushido	superheros
superman	superheros
magnus	superheros
spawn	superheros
prodigy	superheros
blade	superheros
colossus	superheros
quasar	superheros
black_knight	superheros
icarus	superheros
hot_spot	superheros
green_arrow	superheros
puck	superheros
robocop	superheros
flash	superheros
atom	superheros
zorro	superheros
corsair	superheros
hercules	superheros
hyperion	superheros
angel	superheros
warlock	superheros
vision	superheros
the_mask	superheros
synapse	superheros
gambit	superheros
thor	superheros
slipstream	superheros
falcon	superheros
banshee	superheros
tempest	superheros
the_green_hornet	superheros
wild_child	superheros
invincible	superheros
wolverine	superheros
the_shadow	superheros
elixir	superheros
big_red	superheros
hellboy	superheros
blankman	superheros
kato	superheros
cyclops	superheros
robin	superheros
flash_gordon	superheros
guardian	superheros
oldham	english_cities
derby	english_cities
peterborough	english_cities
southend-on-sea	english_cities
slough	english_cities
cambridge	english_cities
nottingham	english_cities
stockport	english_cities
blackburn	english_cities
sheffield	english_cities
newcastle_upon_tyne	english_cities
dudley	english_cities
crawley	english_cities
london	english_cities
norwich	english_cities
poole	english_cities
milton_keynes	english_cities
kingston_upon_hull	english_cities
manchester	english_cities
york	english_cities
luton	english_cities
colchester	english_cities
ipswich	english_cities
liverpool	english_cities
preston	english_cities
stoke-on-trent	english_cities
st_helens	english_cities
bradford	english_cities
oxford	english_cities
sunderland	english_cities
eastbourne	english_cities
reading	english_cities
exeter	english_cities
birmingham	english_cities
plymouth	english_cities
gloucester	english_cities
southampton	english_cities
bolton	english_cities
portsmouth	english_cities
bristol	english_cities
watford	english_cities
leicester	english_cities
blackpool	english_cities
coventry	english_cities
brighton	english_cities
middlesbrough	english_cities
wolverhampton	english_cities
bournemouth	english_cities
swindon	english_cities
liguria	italian_regions
umbria	italian_regions
campania	italian_regions
sicily	italian_regions
abruzzo	italian_regions
tuscany	italian_regions
basilicata	italian_regions
friuli-venezia_giulia	italian_regions
apulia	italian_regions
lombardy	italian_regions
calabria	italian_regions
molise	italian_regions
lazio	italian_regions
aosta_valley	italian_regions
piedmont	italian_regions
marche	italian_regions
veneto	italian_regions
sulfur	elements
platinum	elements
zinc	elements
vanadium	elements
iron	elements
oxygen	elements
silver	elements
copper	elements
mercury	elements
neon	elements
antimony	elements
nickel	elements
carbon	elements
helium	elements
selenium	elements
calcium	elements
krypton	elements
gold	elements
lithium	elements
hydrogen	elements
boron	elements
manganese	elements
lead	elements
kyocera	electronic_companies
xerox	electronic_companies
earthworks	electronic_companies
palm	electronic_companies
dell	electronic_companies
raytheon	electronic_companies
ericsson	electronic_companies
toshiba	electronic_companies
proline	electronic_companies
compaq	electronic_companies
trust	electronic_companies
rca	electronic_companies
qualcomm	electronic_companies
tiberius	roman_emperors
claudius	roman_emperors
marcus_aurelius	roman_emperors
otho	roman_emperors
caligula	roman_emperors
probus	roman_emperors
titus	roman_emperors
gallienus	roman_emperors
quietus	roman_emperors
nerva	roman_emperors
nero	roman_emperors
valerian	roman_emperors
bioinformatics	biology_disciplines
neuroscience	biology_disciplines
psychiatry	biology_disciplines
ecology	biology_disciplines
evolution	biology_disciplines
biotechnology	biology_disciplines
microbiology	biology_disciplines
genetics	biology_disciplines
biochemistry	biology_disciplines
glenn_gould	classical_pianists
franz_schubert	classical_pianists
gregory	classical_pianists
francis_poulenc	classical_pianists
ryan	classical_pianists
leonard_bernstein	classical_pianists
solomon	classical_pianists
franz_liszt	classical_pianists
melody	classical_pianists
wolfgang_amadeus_mozart	classical_pianists
béla_bartók	classical_pianists
john_constable	classical_pianists
aaron_copland	classical_pianists
leslie_howard	classical_pianists
robert_schumann	classical_pianists
frédéric_chopin	classical_pianists
richard_jones	classical_pianists
ludwig_van_beethoven	classical_pianists
władysław_szpilman	classical_pianists
kenya	countries
japan	countries
poland	countries
switzerland	countries
italy	countries
kuwait	countries
bhutan	countries
el_salvador	countries
laos	countries
maldives	countries
albania	countries
mauritius	countries
australia	countries
iraq	countries
suriname	countries
mali	countries
norway	countries
germany	countries
angola	countries
norfolk_island	countries
macedonia	countries
greece	countries
bulgaria	countries
portugal	countries
dominica	countries
malawi	countries
slovenia	countries
luxembourg	countries
american_samoa	countries
jersey	countries
equatorial_guinea	countries
pakistan	countries
russia	countries
mauritania	countries
rwanda	countries
denmark	countries
western_sahara	countries
malta	countries
nigeria	countries
guernsey	countries
togo	countries
saint_kitts_and_nevis	countries
vietnam	countries
estonia	countries
iceland	countries
indonesia	countries
cape_verde	countries
sierra_leone	countries
lesotho	countries
seychelles	countries
solomon_islands	countries
guyana	countries
são_tomé_and_príncipe	countries
egypt	countries
mozambique	countries
lebanon	countries
azerbaijan	countries
myanmar	countries
chad	countries
turkey	countries
ethiopia	countries
croatia	countries
thailand	countries
lithuania	countries
costa_rica	countries
niger	countries
northern_mariana_islands	countries
uzbekistan	countries
nepal	countries
panama	countries
mayotte	countries
tajikistan	countries
argentina	countries
canada	countries
vatican_city	countries
samoa	countries
netherlands	countries
cyprus	countries
united_arab_emirates	countries
federated_states_of_micronesia	countries
monaco	countries
republic_of_macedonia	countries
syria	countries
Åland	countries
congo	countries
mexico	countries
burundi	countries
bahrain	countries
san_marino	countries
new_zealand	countries
austria	countries
vanuatu	countries
republic_of_the_congo	countries
bosnia_and_herzegovina	countries
uganda	countries
cameroon	countries
china	countries
hungary	countries
new_caledonia	countries
burkina_faso	countries
belize	countries
madagascar	countries
kiribati	countries
brazil	countries
east_timor	countries
dominican_republic	countries
tonga	countries
botswana	countries
saint_martin	countries
venezuela	countries
nicaragua	countries
saudi_arabia	countries
haiti	countries
finland	countries
armenia	countries
belgium	countries
singapore	countries
moldova	countries
bolivia	countries
jamaica	countries
saint_vincent_and_the_grenadines	countries
romania	countries
tunisia	countries
montenegro	countries
jordan	countries
libya	countries
turkmenistan	countries
colombia	countries
serbia	countries
israel	countries
gabon	countries
palestine	countries
czech_republic	countries
cuba	countries
andorra	countries
hong_kong	countries
united_kingdom	countries
nauru	countries
slovakia	countries
saint_lucia	countries
tanzania	countries
marshall_islands	countries
palau	countries
spain	countries
somalia	countries
central_african_republic	countries
democratic_republic_of_the_congo	countries
bangladesh	countries
comoros	countries
puerto_rico	countries
barbados	countries
guinea-bissau	countries
senegal	countries
taiwan	countries
afghanistan	countries
kyrgyzstan	countries
trinidad_and_tobago	countries
paraguay	countries
chile	countries
sri_lanka	countries
india	countries
benin	countries
belarus	countries
swaziland	countries
philippines	countries
grenada	countries
zimbabwe	countries
qatar	countries
eritrea	countries
kosovo	countries
côte_d'ivoire	countries
namibia	countries
ukraine	countries
guinea	countries
latvia	countries
south_africa	countries
liberia	countries
france	countries
malaysia	countries
sudan	countries
algeria	countries
ecuador	countries
wallis_and_futuna	countries
guatemala	countries
guam	countries
united_states	countries
morocco	countries
oman	countries
ghana	countries
christmas_island	countries
tuvalu	countries
sweden	countries
yemen	countries
antigua_and_barbuda	countries
liechtenstein	countries
uruguay	countries
kazakhstan	countries
zambia	countries
fiji	countries
peru	countries
iran	countries
djibouti	countries
georgia	countries
pitcairn_islands	countries
cambodia	countries
mary_pickford	best_actress_academy_award_winners
diane_keaton	best_actress_academy_award_winners
reese_witherspoon	best_actress_academy_award_winners
elizabeth_taylor	best_actress_academy_award_winners
barbra_streisand	best_actress_academy_award_winners
katharine_hepburn	best_actress_academy_award_winners
halle_berry	best_actress_academy_award_winners
marlee_matlin	best_actress_academy_award_winners
bette_davis	best_actress_academy_award_winners
jessica_lange	best_actress_academy_award_winners
nicole_kidman	best_actress_academy_award_winners
audrey_hepburn	best_actress_academy_award_winners
grace_kelly	best_actress_academy_award_winners
gwyneth_paltrow	best_actress_academy_award_winners
anne_bancroft	best_actress_academy_award_winners
helen_hunt	best_actress_academy_award_winners
julia_roberts	best_actress_academy_award_winners
cher	best_actress_academy_award_winners
simone_signoret	best_actress_academy_award_winners
joan_crawford	best_actress_academy_award_winners
jane_fonda	best_actress_academy_award_winners
mendocino	california_counties
trinity	california_counties
san_francisco	california_counties
nevada	california_counties
humboldt	california_counties
santa_cruz	california_counties
san_mateo	california_counties
fresno	california_counties
san_diego	california_counties
riverside	california_counties
imperial	california_counties
butte	california_counties
san_benito	california_counties
san_luis_obispo	california_counties
tulare	california_counties
san_bernardino	california_counties
sierra	california_counties
monterey	california_counties
madera	california_counties
napa	california_counties
el_dorado	california_counties
santa_clara	california_counties
shasta	california_counties
merced	california_counties
santa_barbara	california_counties
orange	california_counties
alpine	california_counties
lake	california_counties
los_angeles	california_counties
alameda	california_counties
mariposa	california_counties
mono	california_counties
glenn	california_counties
sacramento	california_counties
ventura	california_counties
modoc	california_counties
