howard	maryland_counties
frederick	maryland_counties
bill_manhire	english_poets
maya_angelou	english_poets
earthquake	cocktails
punch	cocktails
andros	greek_islands
nero	greek_islands
hecate	greek_gods
eros	greek_gods
bunbury	australian_cities
sale	australian_cities
georges_bizet	composers
graham_chapman	composers
hiroshima	japanese_prefectures
gifu	japanese_prefectures
harrison	texas_counties
cherokee	texas_counties
cuenca	spanish_provinces
zamora	spanish_provinces
brian_may	astronomers
albert_einstein	astronomers
mimosa	stars
i	stars
prime	superheros
tarantula	superheros
leeds	english_cities
northampton	english_cities
sardinia	italian_regions
emilia-romagna	italian_regions
radium	elements
cobalt	elements
company	electronic_companies
orion	electronic_companies
augustus	roman_emperors
julian	roman_emperors
anthropology	biology_disciplines
anatomy	biology_disciplines
johannes_brahms	classical_pianists
lang_lang	classical_pianists
macao	countries
honduras	countries
charlize_theron	best_actress_academy_award_winners
emma_thompson	best_actress_academy_award_winners
sonoma	california_counties
kings	california_counties
