dorchester	maryland_counties
st._mary's	maryland_counties
montgomery	maryland_counties
caroline	maryland_counties
garrett	maryland_counties
howard	maryland_counties
somerset	maryland_counties
carroll	maryland_counties
kent	maryland_counties
worcester	maryland_counties
oscar_wilde	english_poets
robert_graves	english_poets
john_keats	english_poets
henry_king	english_poets
henry_wadsworth_longfellow	english_poets
edward_lear	english_poets
william_shakespeare	english_poets
anne_sexton	english_poets
john_betjeman	english_poets
sara_teasdale	english_poets
douglas	cocktails
lorraine	cocktails
prince_of_wales	cocktails
kangaroo	cocktails
sun_city	cocktails
margarita	cocktails
collins	cocktails
cosmopolitan	cocktails
dragonfly	cocktails
greyhound	cocktails
euboea	greek_islands
santorini	greek_islands
ithaca	greek_islands
corfu	greek_islands
lefkada	greek_islands
dia	greek_islands
naxos	greek_islands
andros	greek_islands
nero	greek_islands
kefalonia	greek_islands
eos	greek_gods
hermes	greek_gods
arion	greek_gods
cleopatra	greek_gods
io	greek_gods
calliope	greek_gods
helen	greek_gods
eros	greek_gods
arachne	greek_gods
pan	greek_gods
orange	australian_cities
melbourne	australian_cities
ararat	australian_cities
sale	australian_cities
geelong	australian_cities
palmerston	australian_cities
horsham	australian_cities
albany	australian_cities
burnie	australian_cities
darwin	australian_cities
franz_liszt	composers
hoagy_carmichael	composers
jackie_gleason	composers
cole_porter	composers
william_perry	composers
george_gershwin	composers
antonio_salieri	composers
wolfgang_amadeus_mozart	composers
charles_ives	composers
william_walker	composers
shizuoka	japanese_prefectures
tokushima	japanese_prefectures
kumamoto	japanese_prefectures
akita	japanese_prefectures
niigata	japanese_prefectures
yamanashi	japanese_prefectures
ibaraki	japanese_prefectures
gifu	japanese_prefectures
miyazaki	japanese_prefectures
aomori	japanese_prefectures
ward	texas_counties
wharton	texas_counties
carson	texas_counties
uvalde	texas_counties
bastrop	texas_counties
sterling	texas_counties
hemphill	texas_counties
colorado	texas_counties
throckmorton	texas_counties
washington	texas_counties
ourense	spanish_provinces
albacete	spanish_provinces
león	spanish_provinces
cáceres	spanish_provinces
lleida	spanish_provinces
la_rioja	spanish_provinces
santa_cruz_de_tenerife	spanish_provinces
cuenca	spanish_provinces
ciudad_real	spanish_provinces
alicante	spanish_provinces
galileo_galilei	astronomers
isaac_newton	astronomers
david_levy	astronomers
michael	astronomers
johannes_kepler	astronomers
albert_einstein	astronomers
robert_wilson	astronomers
fred_hoyle	astronomers
robert_kraft	astronomers
will_hay	astronomers
media	stars
castor	stars
polaris	stars
mimosa	stars
atlas	stars
peacock	stars
algol	stars
spica	stars
mira	stars
antares	stars
spider-man	superheros
the_punisher	superheros
daredevil	superheros
link	superheros
ronin	superheros
sunspot	superheros
spawn	superheros
atom	superheros
thor	superheros
tempest	superheros
southend-on-sea	english_cities
dudley	english_cities
norwich	english_cities
milton_keynes	english_cities
ipswich	english_cities
reading	english_cities
plymouth	english_cities
gloucester	english_cities
leicester	english_cities
bournemouth	english_cities
liguria	italian_regions
umbria	italian_regions
sardinia	italian_regions
sicily	italian_regions
abruzzo	italian_regions
emilia-romagna	italian_regions
lazio	italian_regions
aosta_valley	italian_regions
piedmont	italian_regions
veneto	italian_regions
sulfur	elements
platinum	elements
zinc	elements
copper	elements
neon	elements
radium	elements
carbon	elements
gold	elements
hydrogen	elements
lead	elements
xerox	electronic_companies
earthworks	electronic_companies
palm	electronic_companies
dell	electronic_companies
raytheon	electronic_companies
orion	electronic_companies
proline	electronic_companies
trust	electronic_companies
rca	electronic_companies
qualcomm	electronic_companies
tiberius	roman_emperors
otho	roman_emperors
julian	roman_emperors
caligula	roman_emperors
probus	roman_emperors
titus	roman_emperors
quietus	roman_emperors
nerva	roman_emperors
nero	roman_emperors
valerian	roman_emperors
bioinformatics	biology_disciplines
anthropology	biology_disciplines
psychiatry	biology_disciplines
anatomy	biology_disciplines
ecology	biology_disciplines
evolution	biology_disciplines
biotechnology	biology_disciplines
microbiology	biology_disciplines
genetics	biology_disciplines
biochemistry	biology_disciplines
franz_schubert	classical_pianists
solomon	classical_pianists
franz_liszt	classical_pianists
melody	classical_pianists
béla_bartók	classical_pianists
lang_lang	classical_pianists
frédéric_chopin	classical_pianists
richard_jones	classical_pianists
ludwig_van_beethoven	classical_pianists
władysław_szpilman	classical_pianists
norway	countries
ethiopia	countries
thailand	countries
lithuania	countries
new_caledonia	countries
chile	countries
ukraine	countries
latvia	countries
guam	countries
fiji	countries
mary_pickford	best_actress_academy_award_winners
elizabeth_taylor	best_actress_academy_award_winners
katharine_hepburn	best_actress_academy_award_winners
bette_davis	best_actress_academy_award_winners
nicole_kidman	best_actress_academy_award_winners
audrey_hepburn	best_actress_academy_award_winners
gwyneth_paltrow	best_actress_academy_award_winners
anne_bancroft	best_actress_academy_award_winners
helen_hunt	best_actress_academy_award_winners
simone_signoret	best_actress_academy_award_winners
mendocino	california_counties
riverside	california_counties
imperial	california_counties
butte	california_counties
san_luis_obispo	california_counties
santa_barbara	california_counties
orange	california_counties
alpine	california_counties
lake	california_counties
mariposa	california_counties
